ENC = "countries/Enclave.txt"
NWR = "countries/NewReno.txt"
NCR = "countries/NCR.txt"
HUB = "countries/HUB.txt"
MUT = "countries/Mutant.txt"
RED = "countries/Redding.txt"
VLT = "countries/Vault13.txt"
PRM = "countries/PRM.txt"
VTC = "countries/Vaultcity.txt"
UMB = "countries/UMB.txt"
MOD = "countries/MOD.txt"
KHA = "countries/Khans.txt"
KLA = "countries/Kla.txt"
JUN = "countries/Junktown.txt"
TDE = "countries/TheDen.txt"
BOS = "countries/BOS.txt"
ABB = "countries/ABB.txt"
ARO = "countries/Arroyo.txt"
BON = "countries/Boneyard.txt"
NEC = "countries/Necro.txt"
SNF = "countries/SanFran.txt"
NVE = "countries/NVE.txt"
RAI = "countries/RAI.txt"
BIS = "countries/BIS.txt"
BOM = "countries/BOM.txt"
BOO = "countries/BOO.txt"
CCA = "countries/CCA.txt"
CEL = "countries/CEL.txt"
FRE = "countries/FRE.txt"
GOD = "countries/GOD.txt"
JAK = "countries/JAK.txt"
MKA = "countries/MKA.txt"
MRA = "countries/MRA.txt"
NIP = "countries/NIP.txt"
NOV = "countries/NOV.txt"
NRA = "countries/NRA.txt"
POG = "countries/POG.txt"
PRI = "countries/PRI.txt"
TAB = "countries/TAB.txt"
VUN = "countries/VUN.txt"
VUT = "countries/VUT.txt"
GEC = "countries/GEC.txt"
MKM = "countries/MKM.txt"
ULY = "countries/ULY.txt"
TAV = "countries/TAV.txt"
PIT = "countries/PIT.txt"
MNM = "countries/MNM.txt"
ATC = "countries/ATC.txt"
WRW = "countries/WRW.txt"
FEG = "countries/FEG.txt"
IST = "countries/IST.txt"
MLR = "countries/MLR.txt"
RDR = "countries/RDR.txt"
ABN = "countries/ABN.txt"
RSG = "countries/RSG.txt"
GRG = "countries/GRG.txt"
RLR = "countries/RLR.txt"
GUN = "countries/GUN.txt"
BKH = "countries/BKH.txt"
GNB = "countries/GNB.txt"
VEI = "countries/VEI.txt"
DMC = "countries/DMC.txt"
OBL = "countries/OBL.txt"
PTC = "countries/PTC.txt"
ATM = "countries/ATM.txt"
KKK = "countries/KKK.txt"
BTR = "countries/BTR.txt"
MTU = "countries/MTU.txt"
ROY = "countries/ROY.txt"
CBA = "countries/CBA.txt"
SWP = "countries/SWP.txt"
ALS = "countries/ALS.txt"
RFT = "countries/RFT.txt"
BTS = "countries/BTS.txt"
BTX = "countries/BTX.txt"
TPF = "countries/TPF.txt"
TEX = "countries/TEX.txt"
NHU = "countries/NHU.txt"
NKR = "countries/NKR.txt"
NWT = "countries/NWT.txt"
ELJ = "countries/ELJ.txt"
GST = "countries/GST.txt"
HPT = "countries/HPT.txt"
WTL = "countries/WTL.txt"
SOR = "countries/SOR.txt"
DED = "countries/DED.txt"
EIG = "countries/EIG.txt"
BRW = "countries/BRW.txt"



